{
  "bottles": [
    [1, 2, 2, 3],
    [4, 4, 4, 3],
    [5, 6, 6, 1],
    [7, 5, 7, 8],
    [5, 8, 7, 3],
    [9, 8, 1, 7],
    [9, 5, 2, 9],
    [6, 4, 1, 2],
    [3, 6, 9, 8],
    [],
    []
]
}